10 8********
epp*pph*
**p*p***
**p*p***
**p*p***
**ppp***
********
********
********
********
