10 8
***e**h*
***p**p*
*pppppp*
***p****
***p****
*p******
*p*ppp**
********
********
********
