10 8
***pppp*
*p**p*h*
*p**p***
*p**p***
*p**p***
*ppppppe
****p***
*p**p***
*p******
*pppp***
