10 8***pppp*
ep**p*h*
*p**p***
*p**p***
*p**p***
*pppp***
*p**p***
*p**p***
*p******
*pppp***
