10 8
**h*****
**p*****
**p*****
**p***pe
**p***p*
**p***p*
**p***p*
**p***p*
**p***p*
**ppppp*
