10 8********
ep****h*
*p******
*p******
*p******
*pppp***
********
********
********
********
